
NO ./textures/north.xpm
SO ./textures/south.xpm
WE ./textures/west.xpm
EA ./textures/east.xpm

F 112,112,112
C 56,56,56

111111
000W01
111111
