NO ./textures/north.xpm
SO ./textures/south.xpm
WE ./textures/west.xpm
EA ./textures/east.xpm

F 250,200,3
C 54,55,150

111111111111111111111111111111111111111111111111
100000000000000000000000000000000010000000000001
100000000000000000000000000001000010000000000001
100000000000000000000000000001000010000000000001
111111111111110000000000000001000010000000000001
100000000000010000001000000001000010000000000001
100000000000010000000000N00001000010000000000001
100000000000010000001000000001000010000000000001
100000000000010000110000000001111110000000000001
100001000000010000000010000000000000000000000001111111
1000000000000100000000000000000000000000000000011111011
1000000000000100000100000000111111111111110000000000001
1000010000000100000000000000000000000000000000011111111
100000000000000000000000000000000000000000000001
111111111111111111111111111111111111111000000001
111111111111111111111111111111111111111000000001
100000000000000000000000000000000000000000000001
111111111111111111111111111111111111111111111111
